1111111111
1P00E000C1
1111111111