1111111111111111111
10001C000111E000001
1P100101000111001C1
11C001C101000001111
1C11000000010010001
1010111111011010C01
1000000C00000000011
1111111111111111111