1111111111111111111111111111111111111111111
1011111111111111111111111111111111111111101
101CCCC0CCCC0CCCC0CCCC00CCCC0CC000CCCC00101
101C1110C1110C1110C11100C1110C1000C11100101
1S1C1P000C100C1010C10100C1010C1000C100001S1
101C11100C100C1110C11000C1110C1000C11100101
101C00100C100C1010C10100C1000C100000E100101
101C11100C100C1010C10100C1000C1110C11100101
1010000000000000000000000000000000000000101
1S111111111111111111111111111111111111111S1
1010000000000000000000000000000000000000101
1010000011000000000011000000000001100000101
1010011111111000011111111000001111111100101
1010000111100000000111100000000011110000101
1S100010000100000010000100000001000010001S1
1010000000000000000000000000000000000000101
1011111111111111111111111111111111111111101
1111111111111111111111111111111111111111111