1111111111111111111111111111111111111
1C000S00000S0000S0000S0000S0000S000C1
1000000000000000000000000000000000001
1000000010000000100000000000010000001
1P000000000000000000000000000000000E1
1000100000001000000000001000000001001
1000000000000000000000000000000000001
1C000S00000S0000S0000S0000S0000S000C1
1111111111111111111111111111111111111