1111111111111111111111111
1000000010001000100100001
101C101000100010000101101
111111110111101011100C101
10000S0000000010100001101
1101111111110111101111111
1000000010000001000000001
111111011001P101111111101
1000S00000011100000S00101
110111111001E101110111101
1000000010000001000010001
1111110111110111111010101
100000000S000010000001101
1011111111111010101111C01
101C100001000100100001101
1000001000010000001000001
1111111111111111111111111