11111111111111111111111111
10P000000000000C0000000E01
11111111111111111111111111