11111111111111111111111111111111111111
1CCCC0CCCC0CCCC0CCCC0CCCC0C0000CCCC001
1C1110C1110C1110C1110C1110C1000C111001
1C1PC00C100C1010C1010C1010C1000C1CC001
1C11100C100C1110C1100C1110C1000C111001
1CCC100C100C1C10C1C10C1C00C10000CE1001
1C11100C100C1C10C1C10C1C00C1110C111001
10000000000000000000000000000000000001
11111111111111111111111111111111111111