11111111111111111111111111111
1000100S00100S00S00S001C000C1
10001000001000000000001101111
1P0000000010000000000000000C1
10001000001000000000001110011
10001000000000000000001000001
1000100S00100000000000100E001
11111111111111111111111111111