111111111111111111111111111111111111111111
100000S00000000000S00000000000000S00000001
1S11111111111111111111111111111111111111S1
101CCCC0CCCC0CCCC0CCCC0CCCC0CC000CCCC00101
101C1110C1110C1110C1110C1110C1000C11100101
101C1P000C100C1010C1010C1010C1000C10000101
101C11100C100C1110C1100C1110C1000C11100101
101C00100C100C1010C1010C1000C100000E100101
1S1C11100C100C1010C1010C1000C1110C111001S1
101000000000000000000000000000000000000101
101111111111111111111111111111111111111101
100000S00000000000S00000000000000S00000001
111111111111111111111111111111111111111111