1111111111111
1P00000000CE1
1000000000001
1111111111111
