1111111111111
10E0P0C00C1C1
1111111111111
